F 255 ,    0255     ,        255
C      00,     0,     0



NO ./textures/no.xpm
SO ./textures/so.xpm
WE ./textures/we.xpm
EA ./textures/ea.xpm


1111111111
1000000001
1000000001
1000000001                  1111111111
11111W1111                 100000000001
1000000001                  1111111111
1000000001
1111111111


1111111111                  1111111111
1111101111                 100000000001
1000000001                  1111111111
1111111111
