F 51,51,200
C 135,206,255


NO ./textures/no.xpm
SO ./textures/so.xpm
WE ./textures/we.xpm
EA ./textures/ea.xpm


1111111111
1000000001
1000000001
1000000001
11111W1111
1000000001
1000000001
1111111111

