111111111111111111111111111111111
100000000000000000000000000000001
100000000000000000000000000000001
111111111100000011000001111111111
100000000100N00000000001000000001
100000000100000000000001000000001
100000000011111000000111100111111
11000000000100000100000000011
111111111111111000111111001111111
100000000100000000000000000000001
100101110001101010111001111100001
111111100100000100000001100001111
111111111111111111111111111111111
