NO ./path_to_the_north_texture
SO ./path_to_the_south_texture
WE ./path_to_the_west_texture
EA ./path_to_the_est_texture

F 255,255,255
C 225,30,10

        111111111111111111111111111111111
        1000001        100110000000000001
        101100111111111100000000111111111
        1001000000000000000000001
111111111011000001110000000000001
100000000011000001110111111111111
11110011111111101110000001001
11110111111111011101010010001
11111111111111111100000010001
100000N0000000011000000100011
10000000000000011101010010001
11111111111111111111011110011
11110111 1110101 101111010001
11111111 1111111 111111111111
