NO ./textures/no.xpm
SO ./textures/so.xpm
WE ./textures/we.xpm
EA ./textures/ea.xpm

F 51,51,51
C 135,206,235

        111111111111111111111111111111111
        100000111111111100110000000000001
        101100100000001100000000111111111
        1001000000000000000000001
111111111011000001110000000000001
100000000010000001110111111111111
1111001111000110110000001001
11100000000001011101010010001
10000000010111111100000010001
10000000000000001100000010001
100000S0000000011101010010001
11111111111111111111011110011
11110111 1110101 101111010001
11111111 1111111 111111111111
