NO ./path_to_t he_north_texture
SO ./path_to_the_south_texture
WE ./path_to_the_west_texture
EA ./path_to_the_est_texture

F 255,255,255
C 225,30,10

1111111111111111111111
111000000000000000100111111
100000000000000000000000001
100000000000000000000111111
10000000000000000000001
10000000000000000000001
10000000000N00000000001
10000000000000000000001
10000000000000000000001
10000000000000000001001
11110000000000000000001
11111111111111111111111
