NO ./path_to_t he_north_texture
SO ./path_to_the_south_texture
WE ./path_to_the_west_texture
EA ./path_to_the_est_texture

F 255,255,255
C 225,30,10

11111111111111111111111
11100000000000000010011
10000000000000000000011
10000000000000000000011
10000000000000000000001
10000000000000000000001
10000000000N00000000001
10000000000000000000001
10000000000000000000001
10000000000000000001001
11110000000000000000001
11111111111111111111111
